File=Файл
New=Нова сцена
Append=Додати сцену
Open=Відкрити
Recent=Нещодавні
Save=Зберегти
Save As=Зберегти як
Manage Models=Керування моделями
Exit=Вихід
Edit=Редагування
Undo=Скасувати
Redo=Повернути
Style Editor=Редактор стилю
Preferences=Налаштування
Change Language=Змінити мову
Windows=Вікна
Start window=Початкове вікно
Tutorial window=Навчальне вікно
Scene view window=Вікно перегляду сцени
Workspace window=Вікно робочого простору
Console window=Консольне вікно
Log window=Журнал
Layouts=Компонування
Layouts As Submenu=Компонування Як Підменю
Tutorials=Туторіали
Reload=Перезавантажити
Help=Допомога
Description=Опис
Diagnostic tools=Діагностичні інструменти
About=Про програму
Show ImGui demo window=Показати вікно демонстрації ImGui
Debug=Налагодження
Tutorial=Туторіал
No tutorial=Немає туторіалу
Empty tutorial=Порожній туторіал
Open Start Menu=Відкрити початкове меню
< Back=< Назад
< Start Menu=< Початкове меню
Next=Далі
Finish=Завершити
Submit=Надіслати
Incorrect!=Неправильно!
Correct!=Правильно!
Scene View=Перегляд сцени
Settings=Налаштування
Scene=Сцена
World space lighting=Світове освітлення
Manipulators=Маніпулятори
Show manipulators=Показати маніпулятори
Size=Розмір
MSAA=MSAA
OFF=Вимкн.
Highlight=Виділення
Ultra=Ультра
High=Високе
Medium=Середнє
Low=Низьке
Lowest=Мінімальне
Transparency=Прозорість
Use WBOIT=Використовувати WBOIT
WBOIT weight function=Функція ваги WBOIT
Reload shaders=Перезавантажити шейдери
View=Вигляд
Orbit camera=Орбітальна камера
Trackball camera=Камера трекбола
Smooth scroll=Плавне прокручування
Camera fov=Поле зору камери
Show grid=Показати сітку
Viewpoint right=Вигляд справа
Viewpoint left=Вигляд зліва
Viewpoint top=Вигляд зверху
Viewpoint bottom=Вигляд знизу
Viewpoint front=Вигляд спереду
Viewpoint back=Вигляд ззаду
Center camera on selection=Центрувати камеру на вибраному
Center camera on scene=Центрувати камеру на сцені
Show objects=Показати об'єкти
Show axes=Показати осі
Show cameras=Показати камери
Show frustums=Показати фруструми
Object visibility toggle=Перемикач видимості об'єкта
Object visibility=Видимість об'єкта
Objects=Об'єкти
Axes=Осі
Grid=Сітка
Cameras=Камери
Frustums=Фруструми
Toggle world lighting=Перемкнути світове освітлення
Toggle manipulators=Перемкнути маніпулятори
Workspace=Робочий простір
Add=Додати
Model=Модель
Import models...=Імпортувати моделі
Select all=Вибрати все
Invert=Інвертувати
To all=До всього
To selection=До вибраного
Zoom all=Вибрати все
Reset zoom=Скинути масштаб
Show=Показати
Use dots=Використовувати крапки
Add...=Додати...
Choose value...=Виберіть значення...
Angle=Кут
Delete=Видалити
Selected nodes=Вибрані вузли
Selected links=Вибрані зв'язки
All nodes=Усі вузли
All links=Усі зв'язки
Selection=Виділення
Zoom=Збільшити
Rename=Перейменувати
Lock=Заблокувати
Unlock=Розблокувати
Enable synergies=Увімкнути синергію
Disable synergies=Вимкнути синергію
Value=Значення
Reset=Скинути
Store=Зберегти
Restore=Відновити
Decimal digits=Десяткові розряди
Duplicate=Дублювати
Set display mode=Встановити режим відображення
Expanded=Розгорнутий
Value setter=Встановлення значень
Collapsed=Згорнутий
Collapse node=Згорнути вузол
Expand node=Розгорнути вузол
Set visibility=Встановити видимість
Set value=Встановити значення
Show camera=Показати камеру
Show frustum=Показати усічену піраміду
Fill frustum=Заповнити усічену піраміду
Frustum fill color=Колір заповнення усіченої піраміди
Default=За замовчуванням
Red=Червоний
Blue=Синій
Green=Зелений
Yellow=Жовтий
Orange=Помаранчевий
Magenta=Пурпурний
Teal=Бірюзовий
Frustum outline color=Колір контуру усіченої піраміди
Change frustum color=Змінити колір усіченої піраміди
Show model=Показати модель
Opaque=Непрозорий
Back-face culling=Відсікання задньої поверхні(Back-face culling)
Opacity=Непрозорість
None=Відсутній
Brown=Коричневий
Light Blue=Блакитний
Strength=Сила
Change model=Змінити модель
Stop tracking=Зупинити відстеження
Smooth tracking=Плавне відстеження
Start tracking from right=Почати відстеження справа
Start tracking from left=Почати відстеження зліва
Set opacity=Встановити непрозорість
Change color=Змінити колір
Adjust tint=Налаштувати відтінок
Tracking=Відстеження
   once   =один раз
   repeat   =повтор
   ping-pong   =пінг-понг
  smooth step: =  плавний крок:
     step duration: = тривалість кроку:
Automatic step duration=Автоматична тривалість кроку
             single step: =                один крок:
Step for manual Next/Prev=Крок для ручного керування Далі/Попередній
Welcome=Ласкаво просимо
I3T is an educational application that allows the study of 3D transformations and=I3T - це навчальний застосунок, який дозволяє вивчати 3D-трансформації та
 their hierarchy in an illustrative way.= їх ієрархію наочно.
Learn=Вивчення
Transformations=Трансформації
Your scene=Ваша сцена
Start with an empty scene or open your previous work.=Розпочніть з порожньої сцени або відкрийте свою попередню роботу.
No recent files=Немає нещодавніх файлів
Start=Почати
Cancel=Скасувати
OK=ОК
You need to restart the application for all changes to take effect.=Щоб застосувати всі зміни, потрібно перезапустити програму.
Log View=Перегляд журналу
Log output=Вивід журналу
Switch fire action key=Перемкнути клавішу дії вогню
Current keys: %s=Поточні клавіші: %s
Switch=Перемкнути
Console=Консоль
Statistics=Статистика
Frame %d, FPS %.1f=Кадр %d, FPS %.1f
Framerate: %.3f=Частота кадрів: %.3f
Frametime: %.3f=Час кадру: %.3f
CPU Timers:=Таймери ЦП:
GPU Timers:=Таймери ГП:
Total GPU memory %d MB=Всього пам'яті ГП %d МБ
%u MB alloc.=%u МБ виділено.
%u MB free.=%u МБ вільно.
No models imported=Немає імпортованих моделей
Import=Імпортувати
Remove=Видалити
Normalize model size=Нормалізувати розмір моделі
Model details:=Деталі моделі:
No model selected=Не вибрано модель
Import model(s)=Імпортувати модель(і)
Custom theme=Користувацька тема
Use default theme=Використовувати стандартну тему
Revert changes=Скасувати зміни
Reload all Themes=Перезавантажити всі теми
(Discards all unsaved changes)=(Скасує всі незбережені зміни)
Save current modifications to file (discards unsaved changes on other Themes)=Зберегти поточні зміни у файл (скасує незбережені зміни в інших темах)
Overwrite=Перезаписати
Save as=Зберегти як
New theme name=Нова назва теми
Reset to defaults=Скинути до стандартних налаштувань
Edit script=Редагувати скрипт
Script Editor=Редактор скриптів
Save and close=Зберегти та закрити
Reload script=Перезавантажити скрипт
Select Layout=Вибрати компонування
new layout...=нова компоновка...
Save current scene?=Зберегти поточну сцену?
Any unsaved content will be discarded, do you want to save it?=Будь-який незбережений вміст буде втрачено, хочете зберегти його?
Yes=Так
No=Ні
The model '%s' is currently being used by %d model nodes.=Модель '%s' наразі використовується %d вузлами моделі.
The model '%s' is currently being used by %d model node.=Модель '%s' наразі використовується %d вузлом моделі.
Remove model?=Видалити модель?
Are you sure you want to remove it?=Ви впевнені, що хочете видалити?
